WWWWWWWWWWWWWWW
W-------------W
WwwwwwwwwwwwwwW
WSSwwSSSSSSSwwW
WSSSwSSSSSSSSwW
WSSSSSSSSSSSSSW
WSSSSSSSSSSSSSW
WSSSSSSSSSSSSSW
WSSSSSSSSSSSSSW
WSwSSSSSSSSSSSW
WSwwSSSSSSSSSSW
WwwwSSSSSwwSSwW
WwwwwwwwwwwwwwW
W-------------W
WWWWWWWWWWWWWWW
