WWWWWWWWWWWWWWWWWWWW
W------------------W
WDddSSSSSSSSSSSSdddW
WSDSSSSSSSSSSSSddddW
W------SSS---------W
WgGGGGggGGGGGGGGggGW
W--------SSSSSS----W
WDdSdSSSSSSSSSSSdddW
WDddSSSSSSSSSSSSSSdW
WDdSSSSSSSSSSSSSDDdW
W--------SSSSSSSSSSW
WgGGGGGgGGGGgGGGGGgW
WgGGGGgGGGGgg------W
WGGGgGGGgGGGGGGGGgGW
WSSSSSSS-----------W
WSSSSSSSSSSSSSSSSSSW
WSSSSSSSSSSSSSSSSSSW
W-----------SSSSSSSW
WGGGggGGGGgGGGGGGGgW
WWWWWWWWWWWWWWWWWWWW
