WWWWWWWWWWWWWWWWWWWWWWWWWWWWWWWWWWWWWWWW
WDDdSSwwSSSSwwSdDDDDSSwwSddSwwSSwwwSSDDW
WddSSSwwSSSSwwSSDddSdSwwSSSSwwSSwwwSSSdW
WdSSSSSSSSSdwwwwwwwwwwwwSSSSwwSSwwwSSSSW
WSSSSSwwwwwwwwdDSSSSSdSSSSSSSSSSwwwSSSSW
WSSSSSwwwwwwwwSSSSSSSSSSSSSSwwSSwwwSSSSW
WdSSSSSSSSSSwwwwwwSwwwwwSSSSwwSSSSSSSSdW
WDdSSSwwSSSSSSSSSSSSSdwwSSSSwwSSSSSSSSSW
WDddSSwwdSSSwwSSSSSSDdwwSSSSwwSSwwwSdddW
WWWWWWWWWWWWWWWWWWWWWWWWWWWWWWWWWWWWWWWW
