WWWWWWWWWWWWWWWWWWWW
WDDDdddSSSSSSSSSdddW
WDDddSSSSSSSSSSSSSDW
WDdSSSSSSSSSSSSSSddW
WddSSSSSSSSSSSSSSSSW
W------------------W
WSSSSSSSSSSSSSSSSSKW
WSSSSSSSSSSSSSSSSSLW
WSSSSSSSSSSSSSSSSSLW
WSSSSSSSSSSSSSSSSSLW
WTTTTTTTTTTTTTTTYSNW
WWWWWWWWWWWWWWWWWWWW
