WWWWWWWWWWWWWWWWWWWWWWWWW
WGGGGGSSSSSSSSSSSSSSSSSSW
WGGGggSSSSSSSgGGGGGGGGGGW
WSSSSSSSSSSSSGGGGGGGggGGW
WSSSSSSSSSSSSGGgGGGGGGGGW
WSSSSSSSSSSSSGGgGGGgGGGGW
WGGGGGSSSSSSSGGGGGGGGGGgW
WGGgGGSSSSSSSSSSSSSSSSSSW
WGGgGGSSSSSSSSSSSSSSSSSSW
WGGGGGSSSSSSSwwwwwwwwwwwW
WGGGGgSSSSSSSwwwwwwwwwwwW
WGGGGGSSSSSSSwwwwwwwwwwwW
WggGGGSSSSSSSwwwwwwwwwwwW
WgGGGGSSSSSSSwwwwwwwwwwwW
WGGGGGSSSSSSSwwwwwwwwwwwW
WGGGGGSSSSSSSwwwwwwwwwwwW
WgGGGGSSSSSSSwwwwwwwwwwwW
WGGGGGSSSSSSSwwwwwwwwwwwW
WGGGGGSSSSSSSwwwwwwwwwwwW
WGGGgGSSSSSSSwwwwwwwwwwwW
WGGGgGSSSSSSSwwwwwwwwwwwW
WGGGGGSSSSSSSSSSSSSSSSSSW
WGgGGGSSSSSSSSSSSSSSSSSSW
WGGGGgSSSSSSSSSSSSSSSSSSW
WWWWWWWWWWWWWWWWWWWWWWWWW
