WWWWWWWWWWWWWWWWWWWWWWWWWWWWWWWWWWWWWWWWWWWWWWWWWWWWWWWWWWWW
WZZZZZZZZZZZZZZZZZZZZZZZZZZZZZZZZZZZZZZZZZZZZZZZZZZZZZZZZZZW
WZZZZZZZZZZZZZZZZZZZZZZZZZZZZZZZZZZZZZZZZZZZZZZZZZZZZZZZZZZW
WZZZZZZZZZZZZZZZZZZZZZZZZZZZZZZZZZZZZZZZZZZZZZZZZZZZZZZZZZZW
WZZZZZZZZZZZZZZZZZZZZZZZZZZZZZZZZZZZZZZZZZZZZZZZZZZZZZZZZZZW
WZZZZZZZZZZZZZZZZZZZZZZZZZZZZZZZZZZZZZZZZZZZZZZZZZZZZZZZZZZW
WZZZZZZZZZZZZZZZZZZZZZZZZZZZZZZZZZZZZZZZZZZZZZZZZZZZZZZZZZZW
WZZZZZZZZZZZZZZZZZZZZZZZZZZZZZZZZZZZZZZZZZZZZZZZZZZZZZZZZZZW
WZZZZZZZZZZZZZZZZZZZZZZZZZZZZZZZZZZZZZZZZZZZZZZZZZZZZZZZZZZW
WZZZZZZZZZZZZZZZZZZZZZZZZZZZZZZZZZZZZZZZZZZZZZZZZZZZZZZZZZZW
WZZZZZZZZZZZZZZZZZZZZZZZZZZZZZZZZZZZZZZZZZZZZZZZZZZZZZZZZZZW
WZZZZZZZZZZZZZZZZZZZZZZZZZZZZZZZZZZZZZZZZZZZZZZZZZZZZZZZZZZW
WZZZZZZZZZZZZZZZZZZZZZZZZZZZZZZZZZZZZZZZZZZZZZZZZZZZZZZZZZZW
WZZZZZZZZZZZZZZZZZZZZZZZZZZZZZZZZZZZZZZZZZZZZZZZZZZZZZZZZZZW
WZZZZZZZZZZZZZZZZZZZZZZZZZZZZZZZZZZZZZZZZZZZZZZZZZZZZZZZZZZW
WZZZZZZZZZZZZZZZZZZZZZZZZZZZZZZZZZZZZZZZZZZZZZZZZZZZZZZZZZZW
WZZZZZZZZZZZZZZZZZZZZZZZZZZZZZZZZZZZZZZZZZZZZZZZZZZZZZZZZZZW
WZZZZZZZZZZZZZZZZZSSSSSSZSSSSSSSSSSSSSZZZZZZZZZZZSSSSSSSSSSW
WZZZZZZZZZZZZZSSSSSSSSSZZZSSSSSSSSSSSSSSZZZZZZZZSSSSSSSSSSSW
WZZZZZZZZZZZZZSSSSSSSSZSSZSSSSSSSSSSSSSZZZZZZZZZZZSSSSSSSSSW
WZZZZZZZZZZZHHHHHHHHHZHHHHZHHHHHHHHHHHHHHZZZZZZZZHHHHHHHHHHW
WZZZZZZZZZQQQQQQQQQQQZQQQQQZQQQQQQQQQQQQQQQQZZZZQQQQQQQQQQQW
WZZZZZZZqqqqqqqqqqqqqqqqqqZZqqqqZZqqqqqqqqqqqqqZqqqqqqqqqqqW
WZZZZZhhhhhhhhhhhhhhhhhhhhhhhhhhhZZhhhhhhhhhhhhhhhZZhhhhhhhW
WZZZSSSSSSS|SSSSSSSZZSSSSSSSSSSSZZZSSSSSSSSZZZSSZZZZSSSSSSSW
WZSSSSZSSZZ|SZZSSSSZSSSSSSSSSSSSSSSSSSSSSSSSSZZZSSSZSSSSSSSW
WSSSSSZSZZZ|SSZZSSSZSSSSSZZZZZZZSSSSSSSSSSSKTTTTTTTTTTTTTTTW
WTTTTTTTTTTTTTTTYSSSSSSSZZZZZZZZZSSSSSSSSSSLMMMMMZMZZZZZMMMW
WZZMMMZMMMMMZMMZRSSSSSSSSZZZZZZSSSSSSSSSZZSLMMMZZZZZMMMMMMMW
WMMMMZZZMMMMMZMMRSSSSZSSSZSSSSZZSSSSSSSSSZZLMMMMMMMMZZZMMMMW
WMMMMMZMMMMZZZZMRZSSSSZSSSSSSSSZZZSSSSSSSSZLMMMMMZZZMMMMMMZW
WMMMMMZZZMMMMZMZRZZSSSZZSSSSSSSSZZZZSSSSSZZLMMMZZMMMMMMMMMZW
WZZMMMMMZMMMMZZZRZZSSSSZSSSSSSSSSZZZZSSSZZZLMMMMMMMZZZZMMMZW
WBBBBBBBBBBBBBBBUZSSSSZZSSSSSSSSSSZZZSSZZSSLMMMMZZMMMZZMMMZW
WZZSS|SSZZZSS|SZZSSSSSZZZZZSSSSSSSSZZZZZSSSLMZZZZZZZMMMMZZMW
WTTTTTTTTTTTTTYZSSSSSSSSSZZSSSSSSSSSSSSZZZSLMMZZMMMMMMMMMZZW
WMMMMMMZZZZZMMRZSSSSSSSSSSZZSSSSSS------ZZ-NBBBBBBBBBBBBBBBW
WMMZMMZZZZMMMMRSZZSSSSSSSSSSZSSSSSSSSSSSZSSSSSZZSZSwwwwwZwwW
WMZZMMMMZZMZMMRZSSSZSSSSSSSSSZZSSSSSSSSSSSSZSSSSZZZwwwZZZZwW
WMZZZZMMMMMZMMRSSZZZSSSZSSSSSSSZZZSSSSSSSSZSSwwwwZwwwwwwZZZW
WMZMMZZMMZZMZMRSSSSSSSSSSSSSSSSZZZZZSSSSSZZSSwwwwwwwwZZZZwwW
WZZMMMMZZZMMMMRSSSSSSZZZZSSSSSSSSSSZZZSSZZSSSwwwwwwwwwwZZZwW
WBBBBBBBBBBBBBUSSSSSSSSZZSSSSSSSSSZZZZZZSSSSSSSSSSSwwwwwwwZW
WSSSSSSZZZZZZZSZZSSSSSZZSSSSSSSSSSZZZZSZSSSSSSSSSSSwwwwwZZZW
W-------ZZ---SSSSSSSZZZSSSSSSSSSSSSSSSSZZSSSSSSSSSSSSSSSZZSW
WZZZGGGGGGGGGGGGGGGGGGSSSSSSSSSSSSSSSSSSSSSGGGGGGGGGGGGGGZZW
WZZZZZGGGZZGGGGGGGGGGGSSSSSSSSSSSSZZZSSSSSSGGGGGGGGGGGGGZZZW
WGZZZGGGGGGGGGGGGGGGGGSSSSSSSSSSSSSZSSSSSSSGGGGGGGGGGGGGGZZW
WSSSSSSSZZZSSSSSSSSSSSSSSSSSSSSSSSZSSSSSSSSSSSSSSSSSSSSSZZZW
W---------Z-----------SSSSSSSSSSSSZZSSSSSSS--------------ZZW
WSSSSSSSZZZZSSSSSSSSSSSSSSSSSSSSSSSSSSSSSSSSSSSSSSSSSSSZZZZW
WSSSSSSSSZSSSSSSSSSSSSSSSSSSSSSSSSSSSSSSSSSSSSSSSSSSSSSSSSZW
WssssssssZsssssssssssssssssssssssssssssssssssssssssssssssZZW
WsssssssssssssssssssssssssssssssssssssssssssssssssssssssssZW
WwssssssssssssssssssssssssssssssssssssssssssssssssssssssZZZW
WwwwsssssssssssssssssssssssssssssssssssssssssssssssssssssZZW
WwwwwwwwssssssssssssssssssssssssssssssswwwsssssssssssssssssW
WwwwwwwwwwwwwsssssssssssssssssssswwwwwwwwwwwwwwwsssssssssssW
WwwwwwwwwwwwwwwwwwwwwwwwwwwwwwwwwwwwwwwwwwwwwwwwwwwwwwwwwwwW
WWWWWWWWWWWWWWWWWWWWWWWWWWWWWWWWWWWWWWWWWWWWWWWWWWWWWWWWWWWW
