WWWWWWWWWWWWWWWWWWWW
WGGGGGGGGGGGGGGGGGGW
WGGGGGGGGGGGGGGGGGGW
WGGGGGGGGGGGGGGGGGGW
WGGGggggggggggggGGGW
WGGGgSSSSSSSSSSgGGGW
WGGGgSwwwwwwwwSgGGGW
WGGGgSwwwwwwwwSgGGGW
WGGGgSwwSSSSwwSgGGGW
WGGGgSwwSggSwwSgGGGW
WGGGgSwwSggSwwSgGGGW
WGGGgSwwSSSSwwSgGGGW
WGGGgSwwwwwwwwSgGGGW
WGGGgSwwwwwwwwSgGGGW
WGGGgSSSSSSSSSSgGGGW
WGGGggggggggggggGGGW
WGGGGGGGGGGGGGGGGGGW
WGGGGGGGGGGGGGGGGGGW
WGGGGGGGGGGGGGGGGGGW
WWWWWWWWWWWWWWWWWWWW
