WWWWWWWWWWWWWWWWWWWW
WNBBBBBBBBBBBBBBBBUW
WDdddSSSSSSSSSddDDDW
W-------SSSSSSSSdDDW
WDDDdSSSSSSSSdSSSdDW
WDDDdSSSSSSSSdSSSddW
WDDDdSSSSSSSSSSSSddW
W-------SSSSS------W
WHHHHHHHHHHHHHHHHHHW
WQQQQQQQQQQQQQQQQQQW
WqqqqqqqqqqqqqqqqqqW
WhhhhhhhhhhhhhhhhhhW
W-------SSSSS------W
WSSSSSSSSSSSSSSSSSSW
WSSSSSSSSSSSSSSSSSSW
WYSSSSSSSSSSSSSSSSSW
WRSSSSSSSSSSSSSSSSSW
WRSKTTTTTTTTTTTTYSSW
WRSLMMMMMMMMMMMMRSSW
WWWWWWWWWWWWWWWWWWWW
