WWWWWWWWWWWWWWWWWWWWWWWWW
WSSSSSSSSSSSSSSSSSSSSSSSW
WSSSSSSSSSSSSSSSSSSSSSSSW
WSSGGGGGGwwwGGGGGGGGGGSSW
WSSGgGGwwwwwwwGGGGgGGGSSW
WSSGGwwwwGGGGwwGGGGGGGSSW
WSSGGwwwwGgGGGGGGGGGgGSSW
WSSGGwwGGggGGGGGgGGGgGSSW
WSSGGwwGGGGGGGGGGGGGGGSSW
WSSgGGwwGGGGGGGGgGGGGGSSW
WSSGGGGwwGGGGGGGGGGGGGSSW
WSSGGGGGwwGGGGgGGGGGGGSSW
WSSGGgGGGwwwGGGGGGggGGSSW
WSSGGGGGGGgGGGGGGGwGGGSSW
WSSGGGGGGGgGgGGGGGwwGGSSW
WSSwwGGgGGGGGGGGGGwwwGSSW
WSSGwwGGGGGGGGGGwwwGGGSSW
WSSGGwwGGGGGGGGwwwwGGGSSW
WSSGGwGGGGgGGGGGwwwGGGSSW
WSSGgGGGGGGGGGGwwGGGGGSSW
WSSGGGGgGGGGGGGwwwGGgGSSW
WSSGGGGGGGGGGGGgGGGGGGSSW
WSSSSSSSSSSSSSSSSSSSSSSSW
WSSSSSSSSSSSSSSSSSSSSSSSW
WWWWWWWWWWWWWWWWWWWWWWWWW
