WWWWWWWWWW
WBBBBBBBBW
WSSSSSSSSW
WSSSSSSSSW
WSSSSSSSSW
W---S----W
WSSSSSSSSW
W--------W
WTTTTTTTTW
WWWWWWWWWW
