WWWWWWWWWWWWWWWWWWWWWWWWWWWWWW
WNBBBBBBBBBBBBBBBBBBBBBBBBBBUW
WddSSSSSSSSSSSSSSdddSSSddDDDDW
WdSSSSSSSSSSSSSSSSSSSSSSSSdDDW
WSSSS------------------------W
WSSSSSSSSSSSSSSSSSSSSSSSSSdDDW
WSSSSSSSSSSSSSSSSSSSSSSSSSSSdW
W------------------------SSSSW
WDdddSSSSSSSSSSSSSSSSSSSSSSSdW
WddSSSSSSSSSSSSSSSSSSSSSSSdDDW
WSSSSSSSSSSSSSSSSSSSSSDddDDDDW
WSSSS------------------------W
WSSSSSSSSSSSSSSSSSSSSSSSSSdDDW
WSSSSSSSSSSSSSSSSSSSSSSSSSdDDW
WWWWWWWWWWWWWWWWWWWWWWWWWWWWWW
