WWWWWWWWWWWWWWW
WBBBBBBBBBBBBBW
WSSSSSSSSSSSSdW
WSSSSSSSSSSddDW
W----SSSSddDDdW
WSSSSSSSSSdddDW
WSSSSSSSSSSdddW
WYSSSSSSSSSSSSW
WRSSSSSSSSSSSSW
WRSSSSSSSSSSSSW
WRSSSSSSSSSSSSW
WUSSSSSS------W
WSSSSSSSSSSSSSW
WTTTTTTTTTTTTTW
WWWWWWWWWWWWWWW
