WWWWWWWWWWWWWWWWWWWWWWWWW
WwwwwwwwGGGwwwGGGGgGGwwwW
WGGwwwwGGwwwwwwGGGGGGwwwW
WGGGwwGGgGGwwGGGGGgGGwwwW
WGGGGGGGGGGGGGGGGGGGGGwwW
WwGGGGGggGGGGwGGGGGGGwwwW
WwGGGGGGGGGGGwGGGgGGGGwwW
WwwwGGGGGgGGGwGGGGGGGGGwW
WwwGGGGGgGGGGGgGGGGGGGwwW
WwGGGGwGGGGGGGGGGGGgGGGwW
WwGGGwwGGGGgGGGGGGGwwGGGW
WGGGGwGGGGGggGGGGGGwwwGGW
WGgGGGGGwGGGGGGGGGGwwwGGW
WGGGGGwwwwGGGGGGGGGGwwGGW
WGGGgGGwGGGGGGggGGGGGGGGW
WGGGgGGGGgGGGGGGGGwwGGGGW
WGGGGGGGGGGGwwwGGGwwgGGGW
WGGGGGGwGGGGGGgGGGGGgGGGW
WGGGGGGwwwGGGGGGGGGwGGGGW
WGGgGGGGggGGGwGGGGGwwGGGW
WwGGGGwwGGGGwwwGGgwwwGGGW
WwwGwwwwwwwwwwwwwwwwwwwGW
WwwwwwwwwwwwwwwwwwwwwwwwW
WwwwwwwwwwwwwwwwwwwwwwwwW
WWWWWWWWWWWWWWWWWWWWWWWWW
