WWWWWWWWWWWWWWWWWWWW
WHHHHHHHHHHHHHHHHHHW
WQQQQQQQQQQQQQQQQQQW
WqqqqqqqqqqqqqqqqqqW
WhhhhhhhhhhhhhhhhhhW
WSSSSSSSSSSSSSSSSSSW
WSSSSSSSSSSSSSSSSSSW
WGGgGGgGGGGGGGGGgGGW
WGgGGGgGGGGGGggGGGGW
WggGGGGGGgGGGGGGGGGW
WSSSSSSSSSSSSSSSSSSW
WSSSSSSSSSSSSSSSSSSW
WSSSSSSSSSSSSSSSSSSW
W-------SSSS-------W
WGGGgGGGGGGGGGGGGGGW
WwwGgGGGGGGGGgGGGwwW
WwwwGGGgGGGGGGGGwwwW
WwwwwGGGGGGGgGGwwwwW
WwwwwGGGGGGGGGGwwwwW
WwwwGGGgGGGGGgGGwwwW
WwwGGGGGGGGGGGGgGwwW
WGGgGGGgGGGGGGGGGGgW
WGGGGGGgGGGGGGgGGGGW
WGGGGGGGGGGgGGGGGGGW
WWWWWWWWWWWWWWWWWWWW
