WWWWWWWWWWWWWWWWWWWW
WDDDDDDDDDDDDDDDDDDW
WDDDDDDDDDDDDDDDDDDW
WDddddddDDDDDDDDDDDW
WDddSSSSddddDDDDDDDW
WDdSSSSSSSdSSSddDDDW
WDdSSSSSSSSSSSSSdddW
WDSSSSSSSSSSSSSSSdDW
WddSSSSSSSSSSSSSddDW
WDdSSSSSSSSSSSSSSdDW
WDSSSSSSSSSSSSSSddDW
WDdSSSSSSSSSSSSSSSdW
WDSSSSSSSSSSSSSSSddW
WDdddSSSSSSSSSSSSdDW
WdddSSSSSSSSSSSddDDW
WDDddSSSddSSdddDDDDW
WDDDDDddddddddDDDDDW
WDDDDDDDDDDDDDDDDDDW
WDDDDDDDDDDDDDDDDDDW
WWWWWWWWWWWWWWWWWWWW
