WWWWWWWWWWWWWWWWWWWWWWWWWWWWWW
WHHHHHHHHHHHHHHHHHHHHHHHHHHHHW
WQQQQQQQQQQQQQQQQQQQQQQQQQQQQW
WqqqqqqqqqqqqqqqqqqqqqqqqqqqqW
WhhhhhhhhhhhhhhhhhhhhhhhhhhhhW
WSSSSSSSSSSSSSSSSSSSSSSSSSSSSW
WSSSKTTTTTTTTTTTTTTTTTTTTTYSSW
WSSSLMMMMMMMMMMMMMMMMMMMMMRSSW
WSSSLMMMMMMMMMMMMMMMMMMMMMRSSW
WSSSLMMMMMMMMMMMMMMMMMMMMMRSSW
WSSSLMMMMMMMMMMMMMMMMMMMMMRSSW
WSSSNBBBBBBBBBBBBBBBBBBBBBUSSW
WSSSSSSSSSSSSSSSSSSSSSSSSSSSSW
WHHHHHHHHHHHHHHHHHHHHHHHHHHHHW
WQQQQQQQQQQQQQQQQQQQQQQQQQQQQW
WqqqqqqqqqqqqqqqqqqqqqqqqqqqqW
WhhhhhhhhhhhhhhhhhhhhhhhhhhhhW
WSSSSSSSSSSSSSSSSSSSSSSSSSSSSW
WSKTTTTTTYSSSSSSSKTTTTTTTTTYSW
WSLMMMMMMRSSSSSSSLMMMMMMMMMRSW
WSLMMMMMMR---SSSSLMMMMMMMMMRSW
WSLMMMMMMRSSSSSSSLMMMMMMMMMRSW
WSLMMMMMMRSSSSSSSLMMMMMMMMMRSW
WSNBBBBBBUSSSSSSSNBBBBBBBBBUSW
WSSSSSSSSSSSSSSSSSSSSSSSSSSSSW
WHHHHHHHHHHHHHHHHHHHHHHHHHHHHW
WQQQQQQQQQQQQQQQQQQQQQQQQQQQQW
WqqqqqqqqqqqqqqqqqqqqqqqqqqqqW
WhhhhhhhhhhhhhhhhhhhhhhhhhhhhW
WWWWWWWWWWWWWWWWWWWWWWWWWWWWWW
