WWWWWWWWWWWWWWWWWWWWWWWWWWWWWW
WMMMMMRZZZZZZZZZZZZZNBBBBBBBBW
WBBBBBUZZZZSSSSSSSSS|SSSSSZZZW
WZZZZZ|SSSSSSSSSSSSS|SSSSZZZZW
WZZZZZ|SSSSSSSSSSSSSKTTTTTTTTW
WZZZZZ|SSSSSSSSSSSSSLMMMMMMMMW
WTTTTTYZSSSSSSSSSSSZLMMMMZZMMW
WMMZMMRZZSSSSSSSZZZZLMMMZZZMMW
WMZZMMRZSSSSSSSSSSZZLMMZZMMMMW
WMMZZMRZSSSSSSSSSSSZLMMMZMMMMW
WMMMMMRZSSSSSSSSSSSSLMMMMZZMMW
WBBBBBUSSSSSSSSSSSSSLMMMZZMMMW
WSZSSS|SSSSSSSSSSSSSLMMMMMMMMW
WZZSSS|SSSSSSSSSSSSSLMMZZZZMMW
WZSSSS|SSSSSSSSSSSSSNBBBBBBBBW
WTTTTTYSSSSSSSSSSSSSSSSSZZZZZW
WMMMMMRZSSSSSSSSSSSSSSSSSSSSSW
WZZZZMRZZSSSSSSSSSSSSSSSSKTTTW
WMMZMMRZZSSSSSSSSSSSSSSSSLMMMW
WMMZMMRZSSSSSSSSSSSSSSSSSLZZMW
WBBBBBUSSSSSSSSSSSSSSSSSSNBBBW
WSSSSSSSSSSSSSSSSSSSSSSSSSZZZW
WSSSSSSSSSSSSSSSSSSSSSSSSSSSSW
WHHHHHHHHHHHHHHHHHHHHHHHHHHHHW
WQQQQQQQQQQQQQQQQQQQQQQQQQQQQW
WqqqqqqqqqqqqqqqqqqqqqqqqqqqqW
WhhhhhhhhhhhhhhhhhhhhhhhhhhhhW
WSSSSSSSSSSSSSSSSSSSSSSSSSSSSW
WSSSSSSSSSSSSSSSSSSSSSSSSSSSSW
WWWWWWWWWWWWWWWWWWWWWWWWWWWWWW
