WWWWWWWWWWWWWWWWWWWW
WCAacSSSSwwwwwwwwwwW
WCAacSSSSwwwwwwwwwwW
WCAacSSSSSSS-------W
WCAacSSSSSSSSSSGgGGW
WCAacSSSSSSSSSSGGGGW
WCAacSSSSSSSGGgGGgGW
WCAacSSSSSSSGGGGGGGW
WCAacSSSSSSSGGGGGGGW
WCAacSSSSSgGGGGgGGgW
WCAacSSSSSGGGgGGGGGW
WCAacSSSSSGGGGGGGGGW
WCAacSSSSSGGGGggGGGW
WCAacSSSSSSSGGGGGGGW
WCAacSSSSSSSgGGGGgGW
WCAacSSSSSSSGGGGGgGW
WCAacSSSSSSSSSSGGGGW
WCAacSSSSSSSSSSGgGGW
WCAacSSSSS---------W
WWWWWWWWWWWWWWWWWWWW
