WWWWWWWWWWWWWWWWWWWWWWWWWWWWWWWWWWWWWWWW
WSSSSSSSSSSSSSSSSSSSSSSSSSSSSSSSSSSSSSSW
W---------------SSSSSSSS---------------W
WHHHHHHHHHHHHHHH|SSSSSS|HHHHHHHHHHHHHHHW
WQQQQQQQQQQQQQQQ|SSSSSS|QQQQQQQQQQQQQQQW
Wqqqqqqqqqqqqqqq|SSSSSS|qqqqqqqqqqqqqqqW
Whhhhhhhhhhhhhhh|SSSSSS|hhhhhhhhhhhhhhhW
W---------------SSSSSSSS---------------W
WSSSSSSSSSSSSSSSSSSSSSSSSSSSSSSSSSSSSSSW
WSSSSSSSSSSSSSSSSSSSSSSSSSSSSSSSSSSSSSSW
WWWWWWWWWWWWWWWWWWWWWWWWWWWWWWWWWWWWWWWW
