WWWWWWWWWWWWWWWWWWWW
W------------------W
WwwwwwwwwwwwwwwwwwwW
WwwwwwwwwwwwwwwwwwwW
W------------------W
WdSSSSSSSSSSSSSDddDW
WSSSSSSSSSSSSSSddDKW
WSdDSSSSSSSSSSSSSdLW
WSdddSSSSSSSSSSSDDLW
WdddSSSSSSSSSSSdddLW
WDDddSSSSSSSSSSSSdLW
WDDDdSSSSSSSSSSSDDLW
WDddSSSSSSSSSSSSSdLW
WDdddSSSSSSSSSSSdDLW
WddSSSSSSSSSSSSSSDLW
WDdSSSSSSSSSSSSSddLW
WddSSSSSSSSSSSSSdDLW
WdDdSSSSSSSSSSSSdDNW
WDSSSSSSSSSSSSSSDDdW
WdDSSSSSSSSSSSSSSDSW
W------------------W
WwwwwwwwwwwwwwwwwwwW
WwwwwwwwwwwwwwwwwwwW
W------------------W
WWWWWWWWWWWWWWWWWWWW
