WWWWWWWWWWWWWWW
WZZZZZZZZZZZZZW
WZZZZZZZZZZZZZW
WZZZZZZZZZZZZZW
WZZZZZZZZZZZZZW
WZZZZZZZZZZZZZW
WZZZZZZZZZZZZZW
WZZZZSSSSZZZZZW
WZZZSSSSSSZZZZW
WZZSSSSSSSSZZZW
WZSSSSSSSSSSZZW
WZSSSSSSSSSSSZW
WZZSSSSSSSSSSZW
WZZZSSSSSSSSZZW
WZZZZSSSSSSZZZW
WZZZZSSSSSSZZZW
WZZZSSSSSSSSZZW
WZZSSSSSSSSSSZW
W|SSSSSSSSSSSZW
WZSSSSSSSSSSZZW
WZZSSSSSSSSZZZW
WZSSSSSSSSSSZZW
W|SSSSSSSSSSSZW
W|SSSSSSSSSSS|W
W|SSSSSSSSSSS|W
W|SSSSSSSSSSS|W
W|SSSSSSSSSSS|W
W|SSSSSSSSSSS|W
W|SSSSSSSSSSS|W
W|SSSSSSSSSSS|W
W|SSSSSSSSSSS|W
WTTTTTTTTTTTTTW
WMMMMMMMMMMMMMW
WMMMMMMMMMMMMMW
WMMMMMMMMMMMMMW
WWWWWWWWWWWWWWW
