WWWWWWWWWWWWWWWWWWWWWWWWWWWWWW
WZZZZZZZZZZZZZZZZZZZGGGZZZZZZW
WZZZZZZZZZZZZZZZZZGGGGGGZZZZZW
WZZZZZZZZZZZGGGGGGZZZGGGGZZZZW
WZZZZZZZZZZZZZGGGZZGGGGGGGZZZW
WZZZZZZZZZZZZSSSSSZZSSSSZZZZZW
WZZZZZZZZZZZSSSSZZSSSSZZZZZZZW
WZZZZZZZZZSSSSSSSSSSSSSSZZZZZW
WZZZZZZZZZSSSSSZZZSSSSSSZZZZZW
WZZZZZZZZSSSSSZZZZZZSSSSSGZZZW
WZZZZZZZSssssZZZZZsssSSSSGGZZW
WZZZZZZSSsssZZZZsssssSSSSGGZZW
WZZZZZSSSssssssZZssssSSSSGZZZW
WZZZZZZZSssZZsZZZZsssSSSSGGGZW
WZZZZZZSSssZswwwwssssSSSSGGGZW
WZZZGSSSSsZZZwwwwssssSSSSGGGGW
WZGGGSSSZZZZswwwwssssSSSZZZZGW
WGGGGSSSSssssssssssssSSZZZZZZW
WGGGGSSSSssssssssssssSZZZZZGGW
WGggGSSSSssssssssssssZZZZGGGgW
WGGGGSSSSssssssssssssSZZZGGgGW
WgGGGSdddDDdSSSSSSSSSSSZSGgGgW
WGgGGSSdSdDDdDSSSSSddSSSSgGGGW
WGggGSSdSSddddSSSSddSSSSSGGgGW
WGGGGSdDDdSSSSSSSSSSSSSSSGggGW
WGGGgGGGGGgGGggGGGGGGGGGGGGGGW
WgGGGGggGGGgGGGGGGgGGGGggGGgGW
WGggGGGGgGGGGGgGGggGGGGggGGGgW
WggGGGGGgGGGggGGGGGGGGGGGgGGgW
WWWWWWWWWWWWWWWWWWWWWWWWWWWWWW
