WWWWWWWWWWWWWWWWWWWW
WSSSSSSSSSSSSSSSSSSW
WY-----SSS----KTTTTW
WRSSSSSSSSSSSSLMMMMW
WRSSSSSSSSSSSSLMMMMW
WRSSSSSSSSSSSSLMMMMW
WRSSSSSSSSSSSSLMMMMW
WRSSSSSSSSSSSSLMMMMW
WUSSSSSSSSSSSSLMMMMW
WSSSSSSSSSSSSSLMMMMW
WSSSSSSSSS----LMMMMW
WTYSSSSSSSSSSSNBBBBW
WMRSSSSSSSSSSSSSSSSW
WMRSSSSSSSSSSSSKTTTW
WMRSSSSSSSSSSSSLMMMW
WMRSSSSSSSSSSSSLMMMW
WMRSSSSSSSSSSSSLMMMW
WMR------------LMMMW
WMRSSSSSSSSSSSSLMMMW
WWWWWWWWWWWWWWWWWWWW
