WWWWWWWWWWWWWWW
WZZZZZZZZZZZZZW
WZZZZZZZZZZZZZW
WZZZZZZZZZZZZZW
WZZZZZZZZZZZZZW
WZZZZZZZZZZZZZW
WZZSSZSZSZZSSSW
W-------------W
WSSSSSSSSSSSZZW
WZZSSSSSSSSSZZW
WZZZSSSSSSSZZZW
WZZZSSSSSSSZZZW
WZZSSSZSSSZKTTW
WZSSSSZSSZZLMZW
WSSSSSZZSSZLZZW
WZZSSSSSSSSLMMW
WZSSSSSSSSZLMMW
WSSSSSSSSSSNBBW
WSSSSSSS|SSSSSW
WSSSSSSS|SSSSZW
WSSSSSSS|SSSZZW
WSSSSSSS|SZZddW
WSSSSSSS|dDDDDW
WSSSSSSS|DDDDDW
WSSSSSSS|DDDDDW
WWWWWWWWWWWWWWW
