WWWWWWWWWWWWWWWWWWWWWWWWWWWWWWWW
WwwwFFFFFFFFKYFFSSSSSSSSSSdSSSFW
WwwwwFFFFFFFNUFFdSSSSSSSSSDDdSFW
WwwwwwFFFFFFFFFFdSSSSSSSSSSSSSFW
WwwwwwFFFFFFKYFFSSSSSSSSSSSSSSFW
WwwwwFFFFFFFLRFFSSSddddSSSSSSSFW
WwwwFFFFFFFFLRFFSSDDSSSSSSSSSSFW
WFFFFFFFFFFFNUFFSddSSSSSSSSSSSFW
WFFFFFFFFFFFFFFFFFFFFFFFFFFFFFFW
WSSSSSSSSSSSSSSSSSSSSSSSSSSSSSSW
WQQQQQQQQQQQQQQQQQQQQQQQQQQQQQQW
WqqqqqqqqqqqqqqqqqqqqqqqqqqqqqqW
WSSSSSSSSSSSSSSSSSSCAacSSSSSSSSW
WKTYSKYSKTTTTTTTTYdCAacSKTTTTTYW
WLMRdLRSLMMMMMMMMRdCAacSLMMMMMRW
WLMRdLRSLMMMMMMMMRDCAacSLMMMMMRW
WNBUSNUSNBBBBBBBBUSCAacSNBBBBBUW
WSSSSSSSddSSSSSSSSSCAacSSSSSSSSW
WQQQQQQQQQQQQQQQQQQQQQQQQQQQQQQW
WqqqqqqqqqqqqqqqqqqqqqqqqqqqqqqW
WSSSSSSSSSSSSSSSSSSSSSSSSSSSSSSW
WFFFFFFFFFFFFFFFFFFFFFFFFFFFFFFW
WFFFFFFdddDDFFFFFFFFFFFFFFFFFFFW
WFFFFFdDdFFFFFFFFFFFFFFFFFFFKTYW
WGGGFFFFFFFFFFFFFFFFFFFFFFFFLMRW
WgGGGFFFFFFFFFFFFFFFFFFFFFFFLMRW
WggGGFFFFFFFFFFFFFFFFFFFFFFFNBUW
WGGGGGFKTTTYFFKTTTTTTTTTYKTTTTYW
WGGGgGFLMMMRKYLMMMMMMMMMRLMMMMRW
WGGGGGFNBBBUNUNBBBBBBBBBUNBBBBUW
WWWWWWWWWWWWWWWWWWWWWWWWWWWWWWWW
