WWWWWWWWWWWW
WSSSSSSSSSSW
WSSSSSSSSSSW
WSSKTTTTY--W
WSSLMMMMRSSW
WSSLMMMMRSSW
WSSLMMMMRSSW
WSSLMMMMRSSW
WSSNBBBBU--W
WSSSSSSSSSSW
WSSSSSSSSSSW
WWWWWWWWWWWW
