WWWWWWWWWW
WY------KW
WRSSSSSSLW
WRSSSSSSLW
WRSSSSSSLW
WRSSSSSSLW
WRSSSSSSLW
WUSSSSSSNW
W--------W
WWWWWWWWWW
