WWWWWWWWWWWWWWWWWWWWWWWWW
WZZZZZZGGZZGGGwwwwwwwwwwW
WSSZZZGGGgGGGGGwwwwwZZwwW
WSSS|GGGGgGGGGGGwwwwwZZwW
WSSS|GGGGGGGZGZGGwwwZZwwW
WSSS|GGggGGZGGGZGGwwwwwwW
WSSS|GGGGGGGGGGGGGGwwwZwW
WSSS|GZZGGGGGGGZGGGGwwZwW
WSSS|ZGGGGGGGGZZGZZGGwwZW
WSSS|ZGgGGGGGGGGGGGGGwwwW
WSSS|GgGgGGGGGGGZZGGGwwwW
WSSS|GGGGGGGGGGZGGGGGwwwW
WSSS|GGGGGZZZGGGGGGGwwwwW
WSSSSGGGGGGZGGGGGGGwwwZwW
WSSSSGGZZGGGGggZGGwwwZZZW
WSSSSGgGGGGGGGGGGZwwwZZZW
WSSSSGGGGGGGGGGGGZGwZZwwW
WSSSSGGGGGGZGGGGGGGGwZwwW
WSSS|GGGGGGZGGGGggGGGwwwW
WSSS|GZGGGGZGGGGGGGwwZwZW
WSSS|GZGGGGGZZGGGwwwZZZZW
WSSS|GGGgGGGGGGGgwwZZZwwW
WSSS|GGGggGGZZGGGGgwwwwwW
WSSS|GZZGGGGGZZZZGGGwwwwW
WWWWWWWWWWWWWWWWWWWWWWWWW
