WWWWWWWWWWWWWWWWWWWW
WSSSSSSSSSSSSSSSSSSW
WSSSSSSSSSSSSSSSSSSW
WSSSSSGGGGgGGGSSSSSW
WSSSSgGGGGGGGGgSSSSW
WSSSgGGGGGGGGGGGSSSW
WSSGGGGGGggGGGGgGSSW
WSGGgGGGGGGGGGGGGgSW
WGGGGGGGGGGGGGGGGGGW
WggGGGgGwwwwGGGgGGGW
WGGGGGGgwwwwGGGgGGGW
WGGGGGGGwwwwGGGGGGGW
WGGgGGGGwwwwGGGGGGGW
WGGGGGGGggGGGGGGgGGW
WGGGGGGGGgGGGGGgGGGW
WgGGGGGGGGGgGGGGGGGW
WgGGGGGgGGGGGGGGggGW
WwwwwwwwwwwwwwwwwwwW
WwwwwwwwwwwwwwwwwwwW
WWWWWWWWWWWWWWWWWWWW
