WWWWWWWWWWWWWWWWWWWWWWWWWWWWWW
WGGGGGGGGGGggGGGGGGGGGGGGgGGGW
WSSSSSSSSSSSSSSSSSSSSSSSSSSSSW
WSSSSSSSSSSSSSSSSSSSSSSSSSSSSW
WHHHHHHHHHHHHHHHHHHHHHHHHHHHHW
WQQQQQQQQQQQQQQQQQQQQQQQQQQQQW
WqqqqqqqqqqqqqqqqqqqqqqqqqqqqW
WhhhhhhhhhhhhhhhhhhhhhhhhhhhhW
WSSSSSSSSSSSSSSSSSSSSSSSSSSSSW
WTTTTTY-----------SSSSSSS----W
WMMMMMRSSSSSSSSSSSSSSSSSSSSSSW
WMMMMMRSSSSSSSSSSSSSSSSSSKTTTW
WMMMMMRSSSSSSSSSSSSSSSSSSLMMMW
WMMMMMRSSSSSSSSSSSSSSSSSSLMMMW
WMMMMMRSSSSSSSSSS--------LMMMW
WMMMMMRSSSSSSSSSSSSSSSSSSLMMMW
WMMMMMRSSSSSSSSSSSSSSSSSSLMMMW
WMMMMMRSSSSSSSSSSSSSSSSSSLMMMW
WMMMMMRSSSSSSSSSSSSSSSSSSNBBBW
WBBBBBU------SSSSSSSSSSSSSSSSW
WSSSSSSSSSSSSSSSSSSSSSSSSSSSSW
WSSSSSSSSSSSSSSSSSSSSSSSSSSSSW
WHHHHHHHHHHHHHHHHHHHHHHHHHHHHW
WQQQQQQQQQQQQQQQQQQQQQQQQQQQQW
WqqqqqqqqqqqqqqqqqqqqqqqqqqqqW
WhhhhhhhhhhhhhhhhhhhhhhhhhhhhW
WSSSSSSSSSSSSSSSSSSSSSSSSSSSSW
WSSSSSSSSSSSSSSSSSSSSSSSSSSSSW
WGGGGGGGGGgGGGGGGGGGGGGGGGgGGW
WWWWWWWWWWWWWWWWWWWWWWWWWWWWWW
