WWWWWWWWWWWWWWWWWWWW
WCAacSNBBBBBBUSCAacW
WCAacSSSSSSSSSSCAacW
WCAacSSSSSSSSSSCAacW
WCAacSSSSSSSSSSCAacW
WCAacSSSSSSSSSSCAacW
WCAacSSSSSSSSSSCAacW
WCAacSKTTTTTTYSCAacW
WCAacSLMMMMMMRSCAacW
WCAacSLMMMMMMRSCAacW
WCAacSLMMMMMMRSCAacW
WCAacSLMMMMMMRSCAacW
WCAacSLMMMMMMRSCAacW
WCAacSLMMMMMMRSCAacW
WCAacSNBBBBBBUSCAacW
WCAacSSSSSSSSSSCAacW
WCAacSSSSSSSSSSCAacW
WCAacSSSSSSSSSSCAacW
WCAacSKTTTTTTYSCAacW
WWWWWWWWWWWWWWWWWWWW
