WWWWWWWWWWWWWWWWWWWWWWWWWWWWWW
WZZZZZZZSSSSSSSSSSSSSSSZZZZZZW
WZZZZZHHHHZZHHHHHHZHHHHHHHZZZW
WZZZZQQQQQZQQQQQQZZZQQQQQQQZZW
WZZZZZZZZZZZZqqqqqZqqqqqqqZqqW
WZZZZZhhhhZhhhhhhZZhhhhhhhhhZW
WZZZZZZSSZZZSSSSSSSSSSSSSSZZZW
WHHHHHHHHHZHHHHHHHHHHZHHZZZZZW
WZZZZZQQQQQQQZQQQQQQZZZQQQQZZW
WZqZZZqqqqqqqZqqqqqqqZZZZZZZZW
WZhhZZhhhhhhhZZhhhhhhZZhhhhhZW
WSSZSSSSSSSSZZSSSSSZSSSSSSSSSW
WHHHHHHHHHHHHZHHHHHHZZHHHHHHZW
WQQQQZQZQQQQQZZZZQQQQZZQQQZZZW
WqqqZZZZqqqqqqqqqqqqqqqqqqqZZW
WhhhhZhhhhhhhhhhhhhhhhhhhhhhZW
WSSSSSSSSSSSSSSSSSSSSSSSSZSSZW
WSSSSSSSSS|SSSSSSSSSSS|SZSSZZW
WSSSSSSSSS|SSSSSSSSSSS|SZSSZZW
WSSSSSSSSS|SSSSSSSSSSS|SZZZZZW
WWWWWWWWWWWWWWWWWWWWWWWWWWWWWW
