WWWWWWWWWWWWWWWWWWWWWWWWWWWWWW
WHHHHHHHHHHHHHHHHHHHHHHHHHHHHW
WQQQQQQQQQQQQQQQQQQQQQQQQQQQQW
WqqqqqqqqqqqqqqqqqqqqqqqqqqqqW
WhhhhhhhhhhhhhhhhhhhhhhhhhhhhW
WSSSSSSSSSSSSSSSSSSSSSSSSSSSSW
WSSSSSSSSSSSSSSSSSSSSSSSSSSSSW
WggGGGGGgGGGgGGGGGGGGggGGGgGGW
WgGGGGGGgGGGGGggGGgGGGGGGGGGgW
WwwwwwwwwwwwwwwwwwwwwwwwwwwwwW
WWWWWWWWWWWWWWWWWWWWWWWWWWWWWW
