WWWWWWWWWWWWW
WZZZZZZZZZZZW
WZZZZZZZZZZZW
WZZZZSSSZZZZW
WZZZSSSdddSZW
WZZSSdDDDdSSW
WZSSSdDDDSSZW
WZSSSDDDdSSZW
WSSSSddSSSSZW
WZSSSdSSS---W
WZSSSSSSSSDDW
WZSSSSSSSSSdW
WZZSSSSSSSS|W
WZZZSSSSSSS|W
WZZZZSSSSSd|W
WZZZSSSSSdD|W
WZZSSSSSdDD|W
WZSSSSSSSdd|W
WZZSSSSSSSd|W
WZZSSSSSSSS|W
WDDSSSSSSSSDW
WDdSSSSSSZZZW
WSSSSSSSSSZZW
WSSSSSSSSSSDW
WSSSSSS-----W
WSSSSSSSSSdDW
WSSSSSSSSSSDW
WSSSSSSSSSSSW
W-----------W
WWWWWWWWWWWWW
