WWWWWWWWWWWWWWWWWWWWWWWWWWWWWWWWWWW
WDddSSSSSSSSdDdSSSSSSddDDddSSSddddW
WdSSSSSSSSSSSdSSSSSSSSSddSSSSSSSSdW
WHHHHHHHHHHHHHHHHHHHHHHHHHHHHHHHHHW
WQQQQQQQQQQQQQQQQQQQQQQQQQQQQQQQQQW
WqqqqqqqqqqqqqqqqqqqqqqqqqqqqqqqqqW
WhhhhhhhhhhhhhhhhhhhhhhhhhhhhhhhhhW
WSSSSSSSSSSSSSSSSSSSSSSSSSSSSSSSSSW
W---------------------------------W
WWWWWWWWWWWWWWWWWWWWWWWWWWWWWWWWWWW
