WWWWWWWWWWWWWWWWWWWWWWWWWWWWWW
WMZZZZZMMMMMZZZZMMMMRZZZZZZZZW
WMMMMMZZZZMMMMZZMMMMRZZZZZLZZW
WMMMMMMMMZMMZZZMMMMMRZZZZZLMZW
WMMMMMMMZZMMZZMMMMMMR-ZZ--LMZW
WMZMMMMZZZZMMZZZMMMMRSSZSSLMZW
WMZMMZZZZZZZMMZZZMMMRSSSSSLMMW
WZZMMMMZZZMMMZZZMMMMR-----LMMW
WZZZMMMMMZZZZZMMMZZMRDDdSSLMMW
WMMZMMMMMMMMZMMMZZMMRDdSSZNBBW
WMMMMMZZZZZMMMMZZZMMRdSSSZZZZW
WMZZMMMMMMMMMMMMMZZMRdSSSSdDDW
WZZZBBBBBBBBBBBBBBBBUSSSSSddZW
WZZZZZZZZZZZZddDDDDddSSSSSSZZW
WZZZZZZZZZZSSSSdDDddSSSSSSZZZW
WZZZZZZSSSSSSSSSddSSSSSSSSSZZW
WZZZZZSSSSSSSSSSSSSdSSSSSddSZW
WZZZZSSSSSSSSSSSSddDDDSSSSDDDW
WZZZ--------SSSSS------------W
WZZZZSSSSSSSSSSSSSSSSSSSSSSSSW
WZZZZZGGGGGGSSSSSGGGGGGGGGGGGW
WZZZZSSSSSSSSSSSSSSSSSSSSSSSSW
W-----------SSSSS------------W
WSSSSSSSSSSSSSSSSSSSSSSSSSSSSW
WGGGGGGGGGGGSSSSSGGGGGGGGGGGGW
WGGGGGGGGGGGSSSSSGGGGGGGGGGGGW
WSSSSSSSSSSSSSSSSSSSSSSSSSSSSW
WHHHHHHHHHHHHHHHHHHHHHHHHHHHHW
WQQQQQQQQQQQQQQQQQQQQQQQQQQQQW
WWWWWWWWWWWWWWWWWWWWWWWWWWWWWW
