WWWWWWWWWWWWWWWWWWWWWWWWWWWWWW
W-----SSSDDDdddSSSSSSSSGCAacSW
WSSSSddKTTTTTTTTTYSSSSSGCAacSW
WSSddDDLMMMMMMMMMRSSSSSgCAacSW
W--ddDDLMMMMMMMMMRSSSSSgCAacSW
WSSSdddLMMMMMMMMMRSSSSSgCAacSW
WSSSSSDLMMMMMMMMMRSSSSSgCAacSW
WSSSSSDLMMMMMMMMMRSSSSSgCAacSW
WGGggGGNBBBBBBBBBUSSSSSGCAacSW
WGGGGGGGGGGGGgggGGgggGGGCAacSW
WWWWWWWWWWWWWWWWWWWWWWWWWWWWWW
