WWWWWWWWWWWWWWWWWWWW
WMMMMMRSSSSSSSGGwwwW
WMMMMMRSSSSSSSGGwwwW
WBBBBBUSSSSSSSGgwwwW
WdddDDdSSSSSSSGgwwwW
WddDdDSSSSSSSSgGwwwW
WDddSSSSSSSSSSGGwwwW
WSSSSSSSSSSSSSGGwwwW
WSSSSSSSSSSSSSGGwwwW
WSSSSSSSSSSSSSgGwwwW
WSSSSSSSSSSSSSGgwwwW
WSSSSSSSSSSSSSGGwwwW
WSSSSSSSSSSSSSggwwwW
WSSSSSSSSSSSSSGGwwwW
WSSSSSSSSSSSSSGGwwwW
WSSSSSSSSSSSSSgGwwwW
WSSSSSSSSSSSSSGGwwwW
W---SSSSSS----GGwwwW
WSSSSSSSSSSSSSgGwwwW
WWWWWWWWWWWWWWWWWWWW
